############################################################################
#........................................................................../
#..........................................................................#
#..........................................................................#
#..........................................................................#
#..........................................................................#
#..........................................................................#
#..........................................................................#
#..........................................................................#
#..........................................................................#
#..........................................................................#
#..........................................................................#
#..........................................................................#
#..........................................................................#
#..........................................................................#
#...................................A......................................#
#..........................................................................#
#..........................................................................#
#..........................................................................#
#..........................................................................#
#..........................................................................#
#..........................................................................#
#..........................................................................#
#..........................................................................#
#..........................................................................#
#..........................................................................#
#..........................................................................#
#..........................................................................#
############################################################################